@..##.........#####
...#....#####.....
....#.............#
....######........#
..................#
#.....#...........#
#.....#.........###
#.....#...........#
......######.......
.#................#
.#..........#######
##................#
..................#
.....###.....###.##